Here is an example of a maze :

0 0 0 0 0 0 0 0 0 0 0 
0 1 5 1 1 1 0 1 1 1 0 
0 1 0 0 0 0 0 1 0 1 0 
0 1 1 1 0 1 1 1 0 1 0 
0 1 0 1 0 0 0 0 0 1 0 
0 1 0 1 1 1 1 1 1 5 6 
0 1 0 0 0 0 0 0 0 0 0 
0 1 0 1 1 1 1 1 1 1 0 
0 1 0 0 0 0 0 0 0 1 0 
0 1 1 1 1 1 1 1 1 1 0 
0 0 6 0 0 0 0 0 0 0 0 
